111111111111111111       
1m1SSS1SSSS1SSSSS1
1S1S1S1SSSS1S111S1
1S1S1SSS11S1S1S1S1
1S1S1S1SSSS1S1S1S1
1S1S1S111111S1S1S1
1S1S1SSSSSSSS1S1S1
1S1S1111111111S1S1
1S1SSSSSSSSSS1S1S1
1S1S1SS1111111S1S1
1SSS1SSSSSSSSSS1Sa
111111111111111111

